111111111111111111111
10P00000000C000000001
100001111100100100001
10010C0001001C0100001
100100C00100100100C01
10010000C100100100C01
100111100100100100C01
100000000000000100001
100000111111000100001
1000000C000000C000E01
111111111111111111111