1111111111111
1001000000001
1000P11100001
10EP11E0000P1
1111111111111