1111111111111
10010000000C1
10CC0111000C1
10E011E000001
1111111111111