1111111111111
10010000000C1
10CCP111000C1
10EP11E0000P1
1111111111110